1111111111111111111111111
1000110000000000111000001
1001111100000000011000001
1000000000110000001000001
100100000P110000000000001
1001000000000011100000001
1000000000000000000010001
1000011110000000000110001
1111111111111111111111111
