1111111111111111111111111
100011P000000000111000001
1001111100C00000011000001
1000000000110000001000001
10010000001100C0000000001
10010000000000111000C0001
10000C0000000000000C10001
100001111000C00C0001100E1
1111111111111111111111111
