111111111111111111111111111
100011P00000000011100000001
1001111100C0000001100000001
1001111100C0000001100000001
1001111100C0000001100000001
1001111100C0000001100000001
1001111100C0000001100000001
1001111100C0000001100000001
1001111100C0000001100000001
1001111100C0000001100000001
1001111100C0000001100000001
10010000000000111000C000001
10000C0000000000000C1000001
10000C0000000000000C1000001
100001111000C00C0001100E001
111111111111111111111111111
