1111111111111111111111111
10000000000000000000000
100000000P000000000000001
1000000000000000000000001
1111111111111111111111111
